{
  /* VOWELS */
  "a": "अ",
  "á": "आ",
  "e": "ए",
  "é": "ऐ",
  "i": "इ",
  "í": "ई",
  "y": "इ",
  "ý": "ई",
  "o": "ओ",
  "ó": "ओ",
  "u": "उ",
  "ú": "ऊ",
  "ů": "ऊ",

  /* STOPS */
  "p": "प",
  "b": "ब",
  "t": "त",
  "d": "द",
  "k": "क",
  "g": "ग",

  /* NASALS */
  "m": "म",
  "n": "न",
  "ň": "ञ",

  /* FRICATIVES */
  "f": "फ",
  "v": "व",
  "s": "स",
  "z": "ज़",
  "š": "श",
  "ž": "झ़",
  "h": "ह",

  /* AFFRICATES */
  "c": "त्स",
  "č": "च",
  "dž": "ज",

  /* DIGRAPH */
  "ch": "ख",

  /* LIQUIDS & GLIDES */
  "r": "र",
  "l": "ल",
  "j": "य",

  /* SPECIAL CZECH */
  "ř": "ढ़",

  /* PUNCTUATION & SPACE */
  " ": " ",
  ".": ".",
  ",": ",",
  "?": "?",
  "!": "!"
}
